Haute Couture Gallery
....#...##.##...#....
.##...#.#...#.#...##.
.#..#.#...###..#.###.
...#....#.#.##....#..
.##..#.##......##...#
.##.##.##.#.#.#....#.
..#..#......#...##...
#.##...##.#...#..##.#
.....#..#.##.###.....
.##.###....#....#.##.
....#...##...##......