The grand royal jewel exhibit
.....................
...###.........###...
...#.............#...
...#...#######...#...
.......#.....#.......
.......#..J..#.......
.......#.....#.......
...#...###-###...#...
...#.............#...
...###.........###...
.....................
