Museum Entrance
########.............
#####..........##....
###...........####...
#..............##....
.....................
.....................
.....................
...............##....
..............####...
...............##....
.....................
