The Prehistoric Exhibit
...###.........###...
.#.#...###.###...#.#.
.....#..#...#..#.....
#.##...###.###...##.#
..#..#.#.....#.#..#..
.##.##...###...##.##.
..#..#.#.....#.#..#..
#.##...###.###...##.#
.....#..#...#..#.....
.#.#...###.###...#.#.
...###.........###...