The Garden
......#.....##.......
###.#.#.##.###.##.###
.##.#...##.#....#.##.
......#..#...##.#..#.
.##.####.#.####...##.
..#.#....###....#.#..
.##...####.#.####.##.
.#..#.##...#..#......
.##.#....#.##...#.##.
###.##.###.##.#.#.###
.......##.....#......